
WE Textures/foret.xpm
EA Textures/ground.xpm

NO Textures/llaruell.xpm     
C 44,16,39
F 16,39,44
SO Textures/test.xpm

1111111111111111
10000001111
10N001111111
100000111
1111111111111111