11111111111111111111111
10000000000000000000001
10000000000000011100001
10000000000000011100001
10000000000000000000001
10000000000000000000001
10000000000000000000001
10000000000000000000001
10000000000000000000001
10000000000N00000000001
10000000000000000000001
10000000000000000000001
10000000000000000000001
10011100000000000000001
10011100000000000000001
10000000000000000000001
10000000000000000000001
11111111111111111111111