WE Textures/cave_wall.xpm
EA Textures/cave_wall.xpm

NO Textures/cave_wall.xpm
C 153,153,0
F 123,123,0
DO Textures/door2.xpm
SO Textures/cave_wall.xpm

                                                        111111111111
                                                        170006000161
                                                        170000800101
                                                        170000800121
                                                        170000800001
                                                        170000000001
                                                        111111110001
                                                           150000001
                                                           100000001
                         1111111111                        111110001
                         1000000001                   11111111110001
                         1600b00051                   10000007000001       1111111
                         1000000001         111111111110000000000001       1007001
                         1111121111         100000000000000000000001       1000001
     111111111111111111110000000001         100400000000000000040001       1110111
     100000000000400440000000000801         111111100011111111111111         101
     100000000040000000000000900001               10001       11111111111111112111111111111111111
     100000111111111111110400000001               10001       10000000000000000000000000000000001
     1000001            10640000051               10001       10000000000000000000000000000000001
     1800001            11111111111               10001     1110000111111100000000001111111000001
     1000001                                      10001     1000000111111000000000000111111000001
     1000001                                    111000111   100000111110B00000000000c001111100001
     1000001        11111111111111111111111111 10000000001  10001111100c0000000000000B00111110001
11111100000111111   10000000000000000000000001 10000000001  1000111100C000000000000000c0011110001
10000000000000001   10000000000000000000000001110000000001 1000011100C00000000000000000c011100011111
160000000000000011111000CCC00CCc00CBC00CCc0000000000900001100000000000000000000000000000000000000001
100000000000000020000000000000000000000000000000000090000200000000000000000000BB00000000000000000B01
100000000000000011111000Ccc00ccC00CCB00CCC000000000090000110000000000000000000Bc00000000000000000001
11111111111111211   10000000000000000000040441111000000001 1000011100C000000000V00000000B01110001111
        100000001   10000000000000000000445441  1000000001  1000111100B0000000000000000C0011110001
        100000001   10000000001111111111111111  1111111111  10001111100C00000000000000C00111110001
        100110001   10000000001                             100000111110c000000000000C011111000001
11111111100110001   11121111111   1111111111111             10000001111110000000000001111110000001
15000000000010001    10081        100000400400111111111     11100001111111000000000011111110000001
10009000000010001    10001        100000000000000000441       100000000000000000000000000000000001
1600000000441000111111000111111111140000900000111400041       100000000000000000000000000000000001
11111111111110000000000000000000002000080800001 1440041       11111111111111111111111111111111211
            10001111111111111111111000CcB000001 1400041                                    100001
            10001                 1040000000001 1406041                                    100001
            10441                 1111000001111 1111111                                    100601
            10061                 1400000000451                                            111111
            11111                 1000000000001
                                  10440N0404461
                                  1111111111111