WE Textures/night_forest2.xpm
EA Textures/night_forest2.xpm

NO Textures/night_forest2.xpm
C 153,153,0
F 123,123,0
DO Textures/Fence3.xpm
SO Textures/night_forest2.xpm

1111111111111111111111111
1000000000000000000000001
1000000000000000000000001
1000111111121111111000001
1001000000000000000100001
1010000000000000000011001
1e10000000000000000010001
101100000000N000605100001
1K00111111111111111006001
1111111111111111111111111